-1 -1 -1 -1 -1 -1 -1 -1 -1 -1 -1 -1 -1 -1 -1
-1 2 3 4 -1 -1 -1 -1 -1 -1 -1 -1 -1 20 -1
-1 -1 -1 -1 -1 -1 -1 8 9 -1 -1 -1 -1 19 -1
-1 -1 -1 -1 -1 -1 -1 -1 -1 -1 -1 -1 15 16 17
-1 -1 5 3 6 -1 -1 -1 -1 -1 18 -1 -1 -1 -1
-1 -1 -1 -1 -1 -1 10 3 12 -1 -1 -1 -1 -1 -1
-1 1 -1 -1 -1 10 11 14 13 12 -1 -1 -1 18 -1
-1 0 -1 -1 10 11 14 14 14 13 12 -1 -1 -1 -1
3 3 3 3 11 14 14 14 14 14 13 3 3 3 3
14 14 14 14 14 14 14 14 14 14 14 14 14 14 14
